__________________________________________
__________________________________________
__________________________________________
___PPPPPPPPPP_PPPPRRPRPRPPPPPP_PPPPPPPP___
___PRRRPRPRPPSPPRPPPPRPRPRRRPPSPPPPPPOP___
___PPPPPRPRPP_PPRPRRPPPPPRPPPP_PPPPPPPP___
___PRR____________________________________
___PRP____________________________________
___PRPPRPPPPPP_PPPPPRPRPPPP_PPPPPRPPRPP___
___PRPPRPRRRPPSPPRPPRPRRRPPSPPRPPRPPRRP___
___PPPPPPPPRPP_PPRPPPPPPRPP_PPRPPPPPPPP___
____________________________________PRP___
____________________________________PPP___
_____________________________________S____
____________________________________PPP___
____________________________________PPP___
___PPPPRP_PPRPPPPPRPPPPPRPPPP_PPPPRRPRP___
___PPPPRPSPRRPPRPPRPRRPPRPRRPSPPRPPRPRP___
___RRPPPP_PPPPPRPPPPPRPPPPPPP_PPRPPPPPP___
___PPP____________________________________
___RRP____________________________________
___PPP____________________________________
___PRP____________________________________
___PRPPPP_PPPPPRPPPPPPPRPP_PPPRPPRPPPPP___
___PRRPRPSPPRRPRRRPRRRPRRPSPRPRRPRPRPPP___
___PPPPRP_PPPPPPPRPRPPPPPP_PPPPPPPPRRRP___
____________________________________PPP___
____________________________________RRP___
____________________________________PPP___
____________________________________RRP___
___PPPPRPPPPRPPPP_PPPPPPPRRRPPPRP_PRPRP___
___RRRPRPRPPRPRRPSPPRPRRPRPPPPPRPSPRPRP___
___PPPPPPRPPPPPPP_PPRPPRPRPPRRPPP_PPPPP___
___PRR____________________________________
___PPP____________________________________
___PRR____________________________________
___PPRPPPPPPRPPPRPPRP_PPPPPPRPPPPPPPPPP___
___PPRRRPRPPRPPRRRPRPSPRPRRPRPRPPRPPPIP___
___PPPPPPRPPPPPPPPPRP_PRPPPPPPPPPRPPPPP___
__________________________________________
__________________________________________
__________________________________________
