_ _ _ _ _ _ _ _ _ _ _ _ _ _ _ _ _ _ _ _ _ _ _ _ _ _ _ _ _ _ _ _ _ _ _ _ _ _ _ _ _ _
_ _ _ _ _ _ _ _ _ _ _ _ _ _ _ _ _ _ _ _ _ _ _ _ _ _ _ _ _ _ _ _ _ _ _ _ _ _ _ _ _ _
_ _ _ _ _ _ _ _ _ _ _ _ _ _ _ _ _ _ _ _ _ _ _ _ _ _ _ _ _ _ _ _ _ _ _ _ _ _ _ _ _ _
_ _ _ P P P P P P P P P P _ P P P P R R P R P R P P P P P P _ P P P P P P P P _ _ _
_ _ _ P R R R P R P R P P S P P P P R R P R P R P P P P P P S P P P P P P O P _ _ _
_ _ _ P P P P P R P R P P _ P P P P R R P R P R P P P P P P _ P P P P P P P P _ _ _
_ _ _ P R R _ _ _ _ _ _ _ _ _ _ _ _ _ _ _ _ _ _ _ _ _ _ _ _ _ _ _ _ _ _ _ _ _ _ _ _
_ _ _ P R P _ _ _ _ _ _ _ _ _ _ _ _ _ _ _ _ _ _ _ _ _ _ _ _ _ _ _ _ _ _ _ _ _ _ _ _
_ _ _ P R P P R P P P P P P _ P P P P P R P R P P P P _ P P P P P R P P R P P _ _ _
_ _ _ P R P P R P R R R P P S P P R P P R P R R R P P S P P R P P R P P R R P _ _ _
_ _ _ P P P P P P P P R P P _ P P R P P P P P P R P P _ P P R P P P P P P P P _ _ _
_ _ _ _ _ _ _ _ _ _ _ _ _ _ _ _ _ _ _ _ _ _ _ _ _ _ _ _ _ _ _ _ _ _ _ _ P R P _ _ _
_ _ _ _ _ _ _ _ _ _ _ _ _ _ _ _ _ _ _ _ _ _ _ _ _ _ _ _ _ _ _ _ _ _ _ _ P P P _ _ _
_ _ _ _ _ _ _ _ _ _ _ _ _ _ _ _ _ _ _ _ _ _ _ _ _ _ _ _ _ _ _ _ _ _ _ _ _ S _ _ _ _
_ _ _ _ _ _ _ _ _ _ _ _ _ _ _ _ _ _ _ _ _ _ _ _ _ _ _ _ _ _ _ _ _ _ _ _ P P P _ _ _
_ _ _ _ _ _ _ _ _ _ _ _ _ _ _ _ _ _ _ _ _ _ _ _ _ _ _ _ _ _ _ _ _ _ _ _ P P P _ _ _
_ _ _ P P P P R P _ P P R P P P P P R P P P P P R P P P P _ P P P P R R P R P _ _ _
_ _ _ P P P P R P S P R R P P R P P R P R R P P R P R R P S P P R P P R P R P _ _ _
_ _ _ R R P P P P _ P P P P P R P P P P P R P P P P P P P _ P P R P P P P P P _ _ _
_ _ _ P P P _ _ _ _ _ _ _ _ _ _ _ _ _ _ _ _ _ _ _ _ _ _ _ _ _ _ _ _ _ _ _ _ _ _ _ _
_ _ _ R R P _ _ _ _ _ _ _ _ _ _ _ _ _ _ _ _ _ _ _ _ _ _ _ _ _ _ _ _ _ _ _ _ _ _ _ _
_ _ _ P P P _ _ _ _ _ _ _ _ _ _ _ _ _ _ _ _ _ _ _ _ _ _ _ _ _ _ _ _ _ _ _ _ _ _ _ _
_ _ _ P R P _ _ _ _ _ _ _ _ _ _ _ _ _ _ _ _ _ _ _ _ _ _ _ _ _ _ _ _ _ _ _ _ _ _ _ _
_ _ _ P R P P P P _ P P P P P R P P P P P P P R P P _ P P P R P P R P P P P P _ _ _
_ _ _ P R R P R P S P P R R P R R R P R R R P R R P S P R P R R P R P R P P P _ _ _
_ _ _ P P P P R P _ P P P P P P P R P R P P P P P P _ P P P P P P P P R R R P _ _ _
_ _ _ _ _ _ _ _ _ _ _ _ _ _ _ _ _ _ _ _ _ _ _ _ _ _ _ _ _ _ _ _ _ _ _ _ P P P _ _ _
_ _ _ _ _ _ _ _ _ _ _ _ _ _ _ _ _ _ _ _ _ _ _ _ _ _ _ _ _ _ _ _ _ _ _ _ R R P _ _ _
_ _ _ _ _ _ _ _ _ _ _ _ _ _ _ _ _ _ _ _ _ _ _ _ _ _ _ _ _ _ _ _ _ _ _ _ P P P _ _ _
_ _ _ _ _ _ _ _ _ _ _ _ _ _ _ _ _ _ _ _ _ _ _ _ _ _ _ _ _ _ _ _ _ _ _ _ R R P _ _ _
_ _ _ P P P P R P P P P R P P P P _ P P P P P P P R R R P P P R P _ P R P R P _ _ _
_ _ _ R R R P R P R P P R P R R P S P P R P R R P R P P P P P R P S P R P R P _ _ _
_ _ _ P P P P P P R P P P P P P P _ P P R P P R P R P P R R P P P _ P P P P P _ _ _
_ _ _ P R R _ _ _ _ _ _ _ _ _ _ _ _ _ _ _ _ _ _ _ _ _ _ _ _ _ _ _ _ _ _ _ _ _ _ _ _
_ _ _ P P P _ _ _ _ _ _ _ _ _ _ _ _ _ _ _ _ _ _ _ _ _ _ _ _ _ _ _ _ _ _ _ _ _ _ _ _
_ _ _ P R R _ _ _ _ _ _ _ _ _ _ _ _ _ _ _ _ _ _ _ _ _ _ _ _ _ _ _ _ _ _ _ _ _ _ _ _
_ _ _
